22
9
2
10
1 1 1 1 1 1 1 1 1 2 
1 0 0 0 0 0 0 0 0 0 
1 1 1 1 0 1 1 1 1 1 
1 0 0 0 0 0 0 0 0 1 
1 1 1 1 1 1 1 0 1 1 
1 0 0 0 0 0 1 0 0 0 
1 1 0 1 1 1 1 1 1 0 
1 0 0 0 0 0 0 0 0 0 
1 1 1 1 0 0 1 1 1 1 
3 0 0 0 0 0 0 0 0 0 
0 0
0 1
0 2
0 3
0 4
0 5
0 6
0 7
0 8
1 0
2 0
2 1
2 2
2 3
2 5
2 6
2 7
2 8
2 9
3 0
3 9
4 0
4 1
4 2
4 3
4 4
4 5
4 6
4 8
4 9
5 0
5 6
6 0
6 1
6 3
6 4
6 5
6 6
6 7
6 8
7 0
8 0
8 1
8 2
8 3
8 6
8 7
8 8
8 9
